_#####__
_#___##_
##_.$_##
#___.$@#
#__.$__#
##___###
_#####__