_#####__
_#___##_
##_.$.##
#_$$.$@#
#__.$._#
##___###
_#####__